�=
肖=
#=#
@=@
&=&
1=1
2=2
3=3
c=c
e=e
f=f
i=i
m=m
n=n
p=p
r=r
t=t
u=u
w=w
x=x
A=A
S=S
，=，
、=、
。=。
？=？
！=！
％=％
～=～
＋=＋
…=…
・=・
□=□
○=○
☆=☆
※=※
「=「
」=」
（=（
）=）
×=×
０=０
１=１
２=２
３=３
４=４
５=５
６=６
７=７
８=８
９=９
Ａ=Ａ
Ｂ=Ｂ
Ｃ=Ｃ
Ｄ=Ｄ
Ｅ=Ｅ
Ｆ=Ｆ
Ｇ=Ｇ
Ｈ=Ｈ
Ｉ=Ｉ
Ｌ=Ｌ
Ｍ=Ｍ
Ｎ=Ｎ
Ｏ=Ｏ
Ｒ=Ｒ
Ｔ=Ｔ
Ｕ=Ｕ
Ｘ=Ｘ
Ｙ=Ｙ
ａ=ａ
ｂ=ｂ
ｃ=ｃ
ｄ=ｄ
ｍ=ｍ
ｘ=ｘ
あ=あ
か=か
さ=さ
た=た
な=な
は=は
ま=ま
や=や
ら=ら
わ=わ
が=が
ざ=ざ
だ=だ
ば=ば
ぱ=ぱ
ゃ=ゃ
ぁ=ぁ
い=い
き=き
し=し
ち=ち
に=に
ひ=ひ
み=み
ゆ=ゆ
り=り
を=を
ぎ=ぎ
じ=じ
ぢ=ぢ
び=び
ぴ=ぴ
ゅ=ゅ
ぃ=ぃ
う=う
く=く
す=す
つ=つ
ぬ=ぬ
ふ=ふ
む=む
よ=よ
る=る
ん=ん
ぐ=ぐ
ず=ず
づ=づ
ぶ=ぶ
ぷ=ぷ
ょ=ょ
ぅ=ぅ
え=え
け=け
せ=せ
て=て
ね=ね
へ=へ
め=め
れ=れ
げ=げ
ぜ=ぜ
で=で
べ=べ
ぺ=ぺ
っ=っ
ぇ=ぇ
お=お
こ=こ
そ=そ
と=と
の=の
ほ=ほ
も=も
ろ=ろ
ご=ご
ぞ=ぞ
ど=ど
ぼ=ぼ
ぽ=ぽ
ぉ=ぉ
ア=ア
カ=カ
サ=サ
タ=タ
ナ=ナ
ハ=ハ
マ=マ
ヤ=ヤ
ラ=ラ
ワ=ワ
ガ=ガ
ザ=ザ
ダ=ダ
バ=バ
パ=パ
ャ=ャ
ァ=ァ
イ=イ
キ=キ
シ=シ
チ=チ
ニ=ニ
ヒ=ヒ
ミ=ミ
ユ=ユ
リ=リ
ヲ=ヲ
ギ=ギ
ジ=ジ
ヂ=ヂ
ビ=ビ
ピ=ピ
ュ=ュ
ィ=ィ
ウ=ウ
ク=ク
ス=ス
ツ=ツ
ヌ=ヌ
フ=フ
ム=ム
ヨ=ヨ
ル=ル
ン=ン
グ=グ
ズ=ズ
ヅ=ヅ
ブ=ブ
プ=プ
ョ=ョ
ゥ=ゥ
エ=エ
ケ=ケ
セ=セ
テ=テ
ネ=ネ
ヘ=ヘ
メ=メ
レ=レ
ー=ー
ゲ=ゲ
ゼ=ゼ
デ=デ
ベ=ベ
ペ=ペ
ッ=ッ
ェ=ェ
オ=オ
コ=コ
ソ=ソ
ト=ト
ノ=ノ
ホ=ホ
モ=モ
ロ=ロ
ゴ=ゴ
ゾ=ゾ
ド=ド
ボ=ボ
ポ=ポ
ヴ=ヴ
ォ=ォ
逢=一
渇=二
衣=两
各=三
痕=四
岐=五
恭=八
偶=九
希=十
極=半
綴=百
梓=千
圧=万
或=上
葵=下
鰯=中
杏=左
一=右
河=前
詠=后
堪=东
姦=西
高=北
餌=人
梶=入
悪=了
衛=之
葛=又
循=广
迦=口
庵=个
沓=儿
娃=的
壊=年
潟=月
割=日
芦=时
移=分
駕=你
釜=我
誼=它
価=他
株=她
卯=呢
菓=吗
顔=嘛
椅=哦
宛=啊
員=吧
嬢=喂
吹=哼
苦=啦
親=呵
陰=国
強=际
玩=象
彊=棋
鋸=皇
位=能
煙=够
丸=按
含=照
禦=纵
卸=横
閲=斜
按=方
鞍=向
浦=在
怯=盘
休=任
奄=意
吉=移
戯=动
允=那
緊=哪
央=么
姶=地
按=方
燕=放
莞=置
芥=但
袷=是
縁=不
位=能
烏=相
魚=互
罪=堵
茄=住
飴=路
絢=线
蛎=没
院=有
屑=提
胃=示
牙=也
亜=可
姥=以
援=解
応=答
押=案
晦=种
芋=图
啓=里
盈=和
宰=滑
轄=块
矯=连
舘=结
檎=构
雲=成
懐=条
猿=各
居=自
鋭=间
斡=要
憾=交
克=差
策=触
沿=开
鞠=始
胸=走
鯉=乍
依=看
叶=觉
意=得
伽=其
駆=实
継=规
更=律
互=存
愚=首
癌=先
候=随
琴=便
黄=都
距=尝
咽=试
国=联
錦=系
監=旁
唄=边
拐=同
穀=伴
茨=像
印=样
眼=做
云=话
粟=就
蚊=应
俄=该
闇=画
嫁=出
荻=来
閑=接
横=着
喚=再
円=发
園=现
酷=玄
警=机
間=直
萎=为
鵠=避
弘=免
安=这
款=情
歓=况
感=请
項=区
香=域
鵜=如
活=第
蔭=所
塊=说
茅=往
岡=会
碁=怎
姐=正
綾=基
鮎=本
鬼=问
焔=题
昌=遇
粥=们
偲=报
省=酬
委=多
謙=公
准=司
細=招
糾=告
汗=除
艶=点
蛾=外
戒=件
磯=从
訣=收
殴=面
垣=考
柿=虑
茎=选
荊=择
液=比
疫=较
巌=好
施=薪
枝=円
兇=圆
皆=元
開=每
浬=加
牡=去
関=计
巻=算
喰=并
巾=什
恒=太
厭=难
炎=谜
稲=别
挙=烦
佼=琐
亀=认
蝦=真
核=决
殻=定
乙=拿
偉=到
旨=金
歳=额
運=才
軽=给
換=些
掲=社
栄=最
永=初
瑛=然
嫌=剩
掩=合
虎=遗
誇=憾
吟=另
昂=办
何=法
恩=行
匡=找
花=家
桁=门
辞=叉
伊=转
渓=早
稽=晨
紺=阳
往=升
翁=起
羽=当
粁=指
抗=朝
孜=旭
却=张
欺=男
畏=子
協=角
擬=必
遇=须
渋=屋
鎧=调
慣=查
拠=麻
呉=逆
穎=很
頴=简
英=单
舷=弯
芽=过
稼=侧
案=把
工=房
侯=遍
技=未
慌=辛
享=苦
機=反
苛=想
荏=立
近=刻
夏=明
蓋=白
悦=漏
虻=确
革=花
金=费
榎=形
将=屏
叫=由
寒=硬
刊=币
化=排
仮=列
訓=而
怨=组
業=等
厩=只
狂=让
矩=颠
穐=倒
甘=底
仇=顶
骸=换
惟=变
吃=需
謂=位
雇=绝
噂=对
栢=因
巧=疑
苑=果
音=思
洩=目
閏=段
血=跟
於=重
椛=非
樺=常
契=理
飢=胜
軒=负
凝=关
尭=键
塩=将
耕=改
傑=稍
欠=微
爵=稀
砿=糊
期=涂
饗=运
鶏=输
鍵=业
臼=者
菊=水
酌=仓
釈=库
鯖=货
科=物
錫=搞
儀=错
若=橙
寂=苹
蛙=箱
架=全
過=部
呼=替
樫=通
酵=央
求=空
局=利
丑=用
育=顺
郁=序
岸=循
芹=环
餓=回
漁=仅
根=送
砧=进
萱=返
驚=气
佃=魄
畿=虽
験=已
凶=经
愛=被
混=塞
及=何
賀=漂
雅=亮
曳=名
括=还
絵=值
違=数
口=限
亨=制
奥=少
韻=次
削=布
恐=称
階=状
胡=落
企=配
姑=格
咲=范
刑=围
晒=缩
阿=小
供=感
凱=包
憩=更
侠=脑
腰=筋
考=检
堰=注
喝=女
蛍=王
脚=红
厚=局
空=且
且=阻
鰻=字
窺=使
暗=式
忽=填
珊=踏
昆=窍
筋=管
弓=端
客=卡
缶=片
蔚=写
遺=英
泳=文
家=母
異=表
寓=记
繰=载
獅=础
斯=悲
鉛=观
医=语
刈=知
哉=识
橘=学
祉=掌
私=握
鎌=达
倶=头
初=嫌
菌=犯
所=证
護=言
曲=谎
記=共
介=几
侃=复
誤=杂
埼=论
恰=性
廓=与
鈎=矛
劃=盾
謁=大
淫=于
倦=事
貝=却
黍=内
益=容
画=似
臥=乎
疑=帽
億=高
隠=度
塾=檐
雨=长
果=完
完=视
額=眼
勧=睛
艦=类
外=信
巨=己
下=议
崖=轻
駅=易
仰=松
些=误
久=根
佳=火
加=柴
閣=油
緩=灯
縦=暖
重=炉
銃=温
穫=装
語=满
叔=热
夙=浴
肢=池
宿=泡
淑=澡
尉=步
原=恶
嘉=作
厳=剧
衿=烟
襟=燃
謹=切
兼=犬
可=棒
坐=拼
哀=狗
故=安
枯=稳
財=突
渥=驶
旭=汽
葦=车
茜=撞
玉=模
咋=腿
唖=怜
漬=弹
握=驾
鯵=候
扱=心
捌=砝
錆=码
赫=天
悟=秤
卿=无
影=平
映=假
婚=设
敢=量
旗=测
撹=符
貨=猫
憲=抓
恢=老
懸=鼠
維=钟
拳=捉
痔=噱
翫=持
捲=续
臆=工
瑳=狼
砂=鸟
会=渡
詐=岸
鍬=乘
旺=坐
褐=木
沙=筏
霞=吃
禍=掉
干=失
邪=败
査=竹
元=许
魁=生
廻=献
快=曾
怪=极
悔=古
改=产
械=化
禁=宜
為=电
祭=器
愁=传
獣=挺
在=预
借=买
隅=尽
季=折
勤=扣
均=率
嚇=见
終=山
桟=迷
燦=惑
斤=价
欣=钱
欽=低
慧=术
区=词
交=繁
祝=殖
妓=力
縮=恐
粛=怖
回=据
讃=饲
賛=养
斎=刚
亥=阅
域=读
戟=增
衝=怀
辻=孕
杵=孩
僑=镇
兄=城
演=道
索=摸
逸=笔
肱=圈
擦=击
駈=判
錯=钮
許=标
伍=描
駒=断
城=否
五=寻
乞=句
薗=仔
遠=细
暇=快
竣=览
姻=游
通=厢
気=隔
系=午
熊=营
栗=束
桑=客
支=纯
腔=套
研=造
掬=止
祇=船
孝=尖
竃=离
渦=纸
格=例
質=幅
昏=诀
迎=独
噛=程
該=集
掛=清
姿=楚
桓=偶
暁=肯
碍=总
給=诉
嬉=代
債=汇
鴛=察
柑=奇
碓=或
棺=括
曙=沉
讐=员
糊=附
袴=近
賜=岛
篠=海
寡=食
渚=鲨
庶=泳
緒=救
囲=马
御=忘
輝=获
窒=钢
柔=沾
濠=墨
圏=伞
焼=筒
建=主
詣=概
至=雨
糸=抽
型=谁
堅=取
紫=扔
経=骰
繋=则
康=冷
議=静
鹿=投
古=掷
差=玉
堺=妨
榊=碍
匠=停
鴨=减
広=某
彩=蓝
澗=色
才=紫
漢=黄
俺=竖
鰹=挡
鞄=困
庫=杯
桶=具
冠=原
菰=态
糠=余
岩=坚
贋=挑
雁=战
頑=功
願=短
伎=悠
危=久
喜=历
器=史
基=江
奇=户
寄=版
井=书
唆=盛
州=牛
修=奶
稿=残
冴=留
桜=街
検=危
権=险
梗=巨
撮=袭
従=刺
戎=瞎
札=覆
殺=盖
鰍=整
薩=攻
郷=潜
飲=藏
鏡=夜
瓜=岁
后=特
幹=末
窟=龄
汚=新
壕=干
椙=邀
岨=函
侍=坏
巷=插
宴=凹
庄=槽
庚=既
球=星
準=眺
確=望
嘘=型
資=颗
究=球
頚=挥
芸=伟
引=隐
越=倾
況=愿
酒=罪
首=织
儒=卧
汐=姓
構=暗
江=号
受=凶
光=谱
公=歌
街=黑
箇=影
貫=懂
響=付
劾=含
功=义
蒲=及
鑑=郎
射=框
机=推
畦=凌
視=巧
揮=缺
控=笑
需=讯
獲=希
観=浊
採=怒
忌=欠
自=沿
純=叠
絹=乱
界=割
山=渐
劇=守
滋=杏
治=仁
蟹=求
掴=拆
槻=享
茶=柄
惰=孔
幸=穴
什=吻
柵=轴
窄=瞧
傾=洞
硝=播
児=哈
字=吉
女=农
慈=撒
賢=亩
汽=速
竿=倍
学=田
港=欺
溝=骗
嫡=众
橿=汉
照=弧
九=厘
司=毕
豪=哥
銀=径
勝=挤
磁=策
示=辆
看=处
罫=越
拘=玩
群=举
鴻=洲
号=界
合=乌
拷=印
因=周
迂=漫
苅=瓶
喬=菌
境=裂
欝=翻
峡=节
韓=约
硯=混
櫛=脱
鼓=绿
管=典
簡=幻
釧=努
済=贵
最=奖
諌=章
災=教
顕=习
塞=诗
妻=编
弦=蜡
減=烛
幻=烧
穏=阵
手=风
淳=吹
源=熄
玄=灭
償=窗
君=网
習=曲
軍=粘
郡=土
卦=质
舜=挖
駿=掘
喉=征
稀=跳
脂=塘
薫=浮
袈=壤
祁=渗
係=透
集=岔
醜=箭
己=石
洲=副
裁=陷
載=阱
延=凸
海=邮
形=剪
級=异
再=垂
環=辅
慨=菱
惚=积
涯=旗
勺=帜
概=占
鮭=簸
笹=箕
匙=垃
冊=圾
充=搭
脅=扫
刷=远
孫=源
降=封
胆=寄
短=亡
誠=故
素=富
組=豪
椿=莱
章=福
笑=德
赤=氏
賞=萨
幾=罗
詞=梅
洪=夫
説=兴
掘=趣
句=带
陥=克
吋=旅
右=途
毅=响
肝=声
翰=音
西=迪
剛=亚
太=吓
串=逃
県=受
酢=慌
戦=委
珪=托
出=务
此=偷
随=吊
狭=桥
鴬=手
胤=此
滑=今
芝=晚
華=馆
杖=修
竪=阁
靴=楼
榛=娜
慰=健
盾=壮
梱=勇
芯=敢
地=誉
貴=损
消=终
綻=寓
穣=伊
還=杀
条=害
整=摇
寛=消
徐=佣
骨=拉
傷=蒙
肩=责
腫=搜
蛇=尔
甥=米
礁=警
趣=官
起=场
挫=塔
春=扇
馨=打
沖=站
棄=即
蕎=怪
窮=居
笈=民
捨=喜
赦=欢
弛=狭
恥=窄
晃=听
阪=酒
沢=醉
式=耐
灸=斯
醤=波
鐘=绅
黒=士
急=穿
瓦=弄
潅=虚
障=园
航=堂
詰=师
蛋=傅
澄=鲁
蕉=顿
誕=谣
善=踪
殊=耸
帯=诱
耳=拐
塑=详
咳=息
諏=趟
虚=碰
京=恼
蝕=丢
錠=怕
憶=助
倖=乐
早=职
鍛=拾
団=胆
残=鬼
丞=睡
作=板
壇=址
奏=绑
綱=架
弾=瞬
就=追
峨=叫
肯=讨
除=厌
車=甜
植=闲
具=喝
剣=茶
瞬=急
断=府
旋=邸
径=深
騒=优
時=昨
暖=遭
宋=莎
檀=拍
股=店
威=散
掻=逝
禾=爱
事=妻
惣=庭
想=院
掃=墓
段=碑
沼=艾
歎=夏
張=皆
麹=拥
閤=志
桔=礼
弧=身
凹=体
際=适
蒋=雷
館=袋
朕=控
沈=旷
湖=饭
序=雇
心=忠
睡=诚
嘗=胡
緯=显
虞=份
信=阿
侵=玛
双=妈
椎=咋
窃=柔
彫=馅
徴=饼
講=背
蝉=仰
聴=慕
困=肖
蹴=伦
鉱=绘
食=建
鋼=忆
較=美
郭=丽
劫=世
男=赖
樹=朋
綬=友
宇=谓
午=熟
争=悉
色=劝
購=市
堕=泽
談=贝
込=活
倉=跃
漆=桌
新=谈
懇=待
灰=票
止=索
紗=室
四=尼
雌=帮
飼=忙
今=景
谷=闹
少=钥
尚=匙
杭=荒
震=凉
叱=妙
馳=钧
壌=赶
圭=拜
値=赐
産=锁
牽=破
辱=旧
瑚=继
獄=延
漉=伸
覚=饰
嫉=死
知=狙
屋=借
菜=呼
纂=靠
性=迎
逆=保
厨=登
暫=冒
計=牌
峻=竟
設=敦
寸=科
醒=财
尽=秘
粧=密
籍=启
俊=究
轡=层
鯨=遵
斉=埋
瀬=令
智=晃
坑=飞
爾=紧
池=陆
寺=诺
皇=嘱
魂=依
害=补
蒸=齿
戸=轮
甲=零
史=暴
嗣=团
去=伙
狗=斥
士=属
症=药
子=胶
屍=囊
既=颜
貢=淆
市=贴
瀦=素
晶=材
助=品
墾=嘴
尖=唇
証=顾
暢=纠
制=缠
騎=亲
紳=傲
効=慢
娯=弟
懲=吝
挑=啬
師=至
戚=婚
朝=姑
鼠=甥
誌=舒
爽=缓
喋=压
言=猪
奨=耍
絞=吵
蒔=绳
妾=桩
娼=撑
後=姐
兜=距
叡=双
営=胞
嬰=胎
熟=愉
柴=服
術=摆
述=充
我=餐
始=幽
姉=默
醐=戏
玖=飲
躯=戗
升=承
紅=引
遵=骚
村=奋
淡=爆
湛=棚
炭=资
羨=族
青=宝
紘=争
据=命
箪=趁
旦=董
泉=侦
慎=探
図=刊
端=拒
択=验
召=执
而=井
璽=参
朔=宽
結=椅
醇=聚
穴=厅
順=募
鴎=般
諮=强
郊=准
材=备
決=堆
潔=砌
月=纳
景=糖
殉=估
桂=均
死=粒
丘=致
秀=扑
秋=洗
虐=足
掌=腐
捷=朽
抄=饮
招=善
勾=猜
雫=赞
七=岐
頃=饿
歌=光
火=采
珂=购
梢=宠
隙=专
荷=宾
課=奢
嘩=侈
察=阀
夷=脸
十=盆
興=蓄
犠=流
拶=溯
暑=蝴
喧=蝶
健=述
券=鳥
衆=宇
襲=宙
巡=牢
僅=针
溢=铅
鮫=仍
試=课
禽=毫
傘=鱼
汁=擅
軸=兄
携=露
荒=脚
参=矩
蚕=予
氏=丸
識=跑
湿=竞
仔=匹
仕=绪
伺=绕
使=幸
顧=弃
皿=衡
三=卸
艮=桃
佐=灰
拡=展
持=盒
恕=壳
註=售
険=防
遣=阴
仲=艺
算=链
住=钮
